111111111
1E0000111
100C00001
1E0000001
111111111