111111111
1E0001P11
100C00101
1E000000
111111111