111111111
110001P11
100C01111
1E0000001
111111111