111111111
1E0001P11
100C00101
1E0000001
111101111