111111111
1P0100001
10001C001
1000000E1
111111111