111111
1E0001
1P0001
100001
1CCCC1
100001
111111
