1111111111
1P00000001
10C0000E01
1111111111
